_hyponym	_hypernym
_member_meronym	_member_holonym
_derivationally_related_form	_derivationally_related_form
_also_see	_also_see
_verb_group	_verb_group
_member_of_domain_region	_part_of
_member_of_domain_region	_synset_domain_region_of
_synset_domain_region_of	_member_of_domain_region
_instance_hypernym	_instance_hyponym
_instance_hyponym	_instance_hypernym
_also_see	_hypernym
_synset_domain_usage_of	_member_of_domain_usage
_part_of	_has_part
_similar_to	_similar_to
_synset_domain_topic_of	_member_of_domain_topic
_has_part	_part_of
_member_of_domain_topic	_synset_domain_topic_of
_hypernym	_hyponym
_member_holonym	_member_meronym
_member_of_domain_usage	_synset_domain_usage_of
